20 11
####################
#P.#.....#.....#...#
#....#.E....E....E.#
##.###...#.....#...#
#....#.###.....#####
#..E.#.........#..E#
#....###.......#.S.#
#.E..#.......E.#...#
#.......E......##.##
######............# 
     ############## 
