19 7
###################
###################
#...###########...#
#.P......T......P.#
#...########.##...#
#####ST......######
###################
