15 12
###############
#..P..###.ES..#
#.###.###.###.#
#.###.....###E#
#.###.###.###.#
#....E###.....#
#.###.###.###.#
#.###.....###.#
#.###########.#
#.....###E....#
#####.....#####
    #######
