16 7
################
#........E..#..#
#.P.###..##...S#
#....######.####
#.##......#.#..#
#....####.....##
######  #######