26 16
##########################
#...E...#E.#...#.....E#..#
#..#....#................#
#.###.###..##.###.##.##.B#
#..E...#...#..E#..#...#..#
#..........#...#..#.S.####
#......##.##...#..#...#   
###.##.#...##.##..##.##   
#...#..#...#...#.##...### 
#......#E...............# 
#...#..#...#.####.#..E#.# 
##.#####.###.#E.#.#####.# 
#...#..#...#.#......#.#.# 
##P##............##.....# 
#P.P#E.#...###...#E...### 
############ ##########   
