13 9
#############
#P#....E#SE.#
#.#.###.###.#
#.....#.#.#.#
####.##...f.#
#.E#..f.##.##
#.##.#.##...#
#....#....#.#
#############
