17 12
####### #########
#P....###.##....#
#.###......#S#.##
#...###.##.###.##
###.#...#.......#
#...#.#####.T##.#
##.##.#..T####..#
##.#..###.#..#.##
#....##...#.##.# 
#.####..#..E...##
#......##.#.##..#
#################
