10 6
##########
#.P.#..S.#
#...#....#
#...##..##
#........#
##########
