19 16
###################
#P...#.#..........#
#.##.#.#.#####.##.#
#.##.#.#...#...#..#
#..#.#.###.#.####.#
####.#.....#.#..###
#....##.#.##.##...#
#.#.###.#.T#....###
#.#...#.######.### 
#.#####.#....#.#.##
#.......#.##.#.#..#
###.###.#.#..#.##.#
#...#...#.##......#
#.####.##..########
#.......##.......S#
###################
